11111111111111111111111111
100100000000000000000001C1
100P1000000001000000000001
1001000000001C100000000001
10000001000001000000000001
1000001C100000100000100001
10000000000001C00001E10001
10000000000000100000000001
11111111111111111111111111