1111111111111111111111111111111111111111111111111111111111111111
1PCE000000000000000000000000000000000000000000000000000000000001
1111111111111111111111111111111111111111111111111111111111111111
1010000000000000000000000000000000000000000000000000000000000101
1011111111111111111111111111111111111111111111111111111111111101
1010000000000000000000000000000000000000000000000000000000000101
1011111111111111111111111111111111111111111111111111111111111101
1010000000000000000000000000000000000000000000000000000000000101
1011111111111111111111111111111111111111111111111111111111111101
1010000000000000000000000000000000000000000000000000000000000101
1011111111111111111111111111111111111111111111111111111111111101
1010000000000000000000000000000000000000000000000000000000000101
1011111111111111111111111111111111111111111111111111111111111101
1010000000000000000000000000000000000000000000000000000000000101
1011111111111111111111111111111111111111111111111111111111111101
1010000000000000000000000000000000000000000000000000000000000101
1011111111111111111111111111111111111111111111111111111111111101
1010000000000000000000000000000000000000000000000000000000000101
1011111111111111111111111111111111111111111111111111111111111101
1010000000000000000000000000000000000000000000000000000000000101
1011111111111111111111111111111111111111111111111111111111111101
1010000000000000000000000000000000000000000000000000000000000101
1011111111111111111111111111111111111111111111111111111111111101
1010000000000000000000000000000000000000000000000000000000000101
1011111111111111111111111111111111111111111111111111111111111101
1010000000000000000000000000000000000000000000000000000000000101
1011111111111111111111111111111111111111111111111111111111111101
1010000000000000000000000000000000000000000000000000000000000101
1011111111111111111111111111111111111111111111111111111111111101
1010000000000000000000000000000000000000000000000000000000000101
1011111111111111111111111111111111111111111111111111111111111101
1010000000000000000000000000000000000000000000000000000000000101
1111111111111111111111111111111111111111111111111111111111111111