11111111111111111111111111111111
10000100000001000000000000000001
100C01000000010000000S0010P00001
10111100001111111100000111111001
10C001000C1C000000000S0010001001
11110100001111111100000010001111
100001000C1C000000000S0011000001
10C00100001111111100000001110001
100001000C1C000000000S0001000001
11110100001111111100000001011111
100001000000001000000S0001000001
10000000001111111111111001000001
10000000000000000000001001000001
111111000100000000000S1001000001
10000000010000000000001001000001
10E00000010000000000001000000001
10000000010000000000000000000001
11111111111111111111111111111111
