1111111111
1P0E000001
1110000001
10S0000001
10S00C0001
1000000001
10S0000001
10S0000101
10S00001C1
1111111111