1111111111
1P0E000001
1110000001
1000000001
10000C0001
1000000001
1000000001
1000000101
10000001C1
1111111111