11111111111111111111111111111111111111111111111111
1P0000000000C0000000000000000000000000000000000001
10111111111111111111111110000000000000000000000001
101000000000C00000000000100S0000000000000000000001
101011111111111111111110100000S0000000000000000001
101010000000C00000000010100000000S0000000000000001
101010111111111111111010100000000000S0000000000001
101010100000C00000001010100000000000000S0000000001
101010101111111111101010100000000000000000S0000001
101010101000C000001C1C1C100000000000000000000S0001
10101010101111111010101010000000000000000000000001
10101010101C000C10101010100S0000000000000000000001
101010101011001010101010100000S0000000000000000001
1010101010100C10101010101000000000S000000000000001
1010101010111110101010101000000000000S000000000001
101010101000000C101010101000000000000000S000000001
1C1C1C1C11111111101010101000000000000000000S000001
1010101000000000001010101000000000000000000000S001
101010111111111111101010100S0000000000000000000001
101010000000000000001010100000S0000000000000000001
101011111111111111111010100000000S0000000000000001
101000000000000000000010100000000000S0000000000001
101111111111111111111110100000000000000S0000001111
10000000000000000000000010000000000000000000000EC1
11111111111111111111111111111111111111111111111111