11111111111111111111111111111111111111111111111111111111111111111
1PCE0000000000000000000000000000000000000000000000000000000000001
11111111111111111111111111111111111111111111111111111111111111111